xxxxxxxxxxxxxxxxxxxxxxxxxxxxxxxxxxxxxxxxxxxxxxxxxxxxxxxxxxxxxxxxxxxxxxxxxxxxxxxxxxxxxxxxxxxxxxxx
x            P                                                                                Jx
x 	    xxx			 @					      #		  xxxxxx
x    				xxx		                             xxx               x
x      xxx                                   xxxxxx   xxxxxx             x          xxxx       x
x FFFFFF     @            !                                                                    x
x xxxxxx    xxx          xxx           xxx                          xx                         x
x                                                 #   $                                        x
x                                                 x   x       xxx      xxx    xxx              x
x                 xxxxx        xxxxx                                                  x xx     x
x                                                                                 xx    xx  x  x
x            !                                                                          xx     x
x  O       xxxxx         xxx                                                            xxx    x
x! D               FFFFFFFFFFFFFFFFFFFFFFFFFFFFFFFFFFFFF  %  AAAAAAAAAAAAAAAAAAAAAAAAAAAxx   T x
xxxxxxxxxxxxxxxxxxxxxxxxxxxxxxxxxxxxxxxxxxxxxxxxxxxxxxxxxxxxxxxxxxxxxxxxxxxxxxxxxxxxxxxxxxxxxxxx       